0000000001000000000000000000000000000000
0000000001000000000000000000000000000000
0000000001000000000000000000000000000000
0000000001000000000000000000000000000000
1111111111111111111111111111111111111111
0000000001000000000000000001000000000000
0000000001000000000000000001000000000000
0000000001000000000000000001000000000000
0000000001000000000000000001000000000000
0000000001000000000000000001000000000000
0000000001000000000000000001000000000000
0000000001000000000000000001000000000000
0000000001000000000000000001000000000000
1111111115111111111111111111111111111111
0000000001000000000000000001000000000000
0000000001000000000000000001000000000000
0000000001000000000000000001000000000000
0000000001000000000000000001000000000000
0000000001000000000000000001000000000000
0000000001000000000000000001000000000000
0000000001000000000000000001000000000000
0000000001000000000000000001000000000000
0000000001000000000000000001000000000000
1111111111111111111111111111111111111111