000000000100000000000000000000000000000000000000010000000000000000000000000000000000000001000000000000000000000000000000
000000000100000000000000000000000000000000000000010000000000000000000000000000000000000001000000000000000000000000000000
000000000100000000000000000000000000000000000000010000000000000000000000000000000000000001000000000000000000000000000000
000000000100000000000000000000000000000000000000010000000000000000000000000000000000000001000000000000000000000000000000
111111111111111111111111111111111111111111111111111111111111111111111111111111111111111111111111111111111111111111111111
000000000100000000000000000100000000000000000000010000000000000000010000000000000000000001000000000000000001000000000000
000000000100000000000000000100000000000000000000010000000000000000010000000000000000000001000000000000000001000000000000
000000000100000000000000000100000000000000000000010000000000000000010000000000000000000001000000000000000001000000000000
000000000100000000000000000100000000000000000000010000000000000000010000000000000000000001000000000000000001000000000000
000000000100000000000000000100000000000000000000010000000000000000010000000000000000000001000000000000000001000000000000
000000000100000000000000000100000000000000000000010000000000000000010000000000000000000001000000000000000001000000000000
000000000100000000000000000100000000000000000000010000000000000000010000000000000000000001000000000000000001000000000000
000000000100000000000000000100000000000000000000010000000000000000010000000000000000000001000000000000000001000000000000
111111111111111111111111111111111111111111111111111111111111111111111111111111111111111111111111111111111111111111111111
000000000100000000000000000100000000000000000000010000000000000000010000000000000000000001000000000000000001000000000000
000000000100000000000000000100000000000000000000010000000000000000010000000000000000000001000000000000000001000000000000
000000000100000000000000000100000000000000000000010000000000000000010000000000000000000001000000000000000001000000000000
000000000100000000000000000100000000000000000000010000000000000000010000000000000000000001000000000000000001000000000000
000000000100000000000000000100000000000000000000010000000000000000010000000000000000000001000000000000000001000000000000
000000000100000000000000000100000000000000000000010000000000000000010000000000000000000001000000000000000001000000000000
000000000100000000000000000100000000000000000000010000000000000000010000000000000000000001000000000000000001000000000000
000000000100000000000000000100000000000000000000010000000000000000010000000000000000000001000000000000000001000000000000
000000000100000000000000000100000000000000000000010000000000000000010000000000000000000001000000000000000001000000000000
111111111111111111111111111111111111111111111111111111111111111111111111111111111111111111111111111111111111111111111111
000000000100000000000000000000000000000000000000010000000000000000000000000000000000000001000000000000000000000000000000
000000000100000000000000000000000000000000000000010000000000000000000000000000000000000001000000000000000000000000000000
000000000100000000000000000000000000000000000000010000000000000000000000000000000000000001000000000000000000000000000000
000000000100000000000000000000000000000000000000010000000000000000000000000000000000000001000000000000000000000000000000
111111111111111111111111111511111111111111111111111111111111111111111111111111111111111111111111111111111111111111111111
000000000100000000000000000100000000000000000000010000000000000000010000000000000000000001000000000000000001000000000000
000000000100000000000000000100000000000000000000010000000000000000010000000000000000000001000000000000000001000000000000
000000000100000000000000000100000000000000000000010000000000000000010000000000000000000001000000000000000001000000000000
000000000100000000000000000100000000000000000000010000000000000000010000000000000000000001000000000000000001000000000000
000000000100000000000000000100000000000000000000010000000000000000010000000000000000000001000000000000000001000000000000
000000000100000000000000000100000000000000000000010000000000000000010000000000000000000001000000000000000001000000000000
000000000100000000000000000100000000000000000000010000000000000000010000000000000000000001000000000000000001000000000000
000000000100000000000000000100000000000000000000010000000000000000010000000000000000000001000000000000000001000000000000
111111111111111111111111111111111111111111111111111111111111111111111111111111111111111111111111111111111111111111111111
000000000100000000000000000100000000000000000000010000000000000000010000000000000000000001000000000000000001000000000000
000000000100000000000000000100000000000000000000010000000000000000010000000000000000000001000000000000000001000000000000
000000000100000000000000000100000000000000000000010000000000000000010000000000000000000001000000000000000001000000000000
000000000100000000000000000100000000000000000000010000000000000000010000000000000000000001000000000000000001000000000000
000000000100000000000000000100000000000000000000010000000000000000010000000000000000000001000000000000000001000000000000
000000000100000000000000000100000000000000000000010000000000000000010000000000000000000001000000000000000001000000000000
000000000100000000000000000100000000000000000000010000000000000000010000000000000000000001000000000000000001000000000000
000000000100000000000000000100000000000000000000010000000000000000010000000000000000000001000000000000000001000000000000
000000000100000000000000000100000000000000000000010000000000000000010000000000000000000001000000000000000001000000000000
111111111111111111111111111111111111111111111111111111111111111111111111111111111111111111111111111111111111111111111111
000000000100000000000000000000000000000000000000010000000000000000000000000000000000000001000000000000000000000000000000
000000000100000000000000000000000000000000000000010000000000000000000000000000000000000001000000000000000000000000000000
000000000100000000000000000000000000000000000000010000000000000000000000000000000000000001000000000000000000000000000000
000000000100000000000000000000000000000000000000010000000000000000000000000000000000000001000000000000000000000000000000
111111111111111111111111111111111111111111111111111111111111111111111111111111111111111111111111111111111111111111111111
000000000100000000000000000100000000000000000000010000000000000000010000000000000000000001000000000000000001000000000000
000000000100000000000000000100000000000000000000010000000000000000010000000000000000000001000000000000000001000000000000
000000000100000000000000000100000000000000000000010000000000000000010000000000000000000001000000000000000001000000000000
000000000100000000000000000100000000000000000000010000000000000000010000000000000000000001000000000000000001000000000000
000000000100000000000000000100000000000000000000010000000000000000010000000000000000000001000000000000000001000000000000
000000000100000000000000000100000000000000000000010000000000000000010000000000000000000001000000000000000001000000000000
000000000100000000000000000100000000000000000000010000000000000000010000000000000000000001000000000000000001000000000000
000000000100000000000000000100000000000000000000010000000000000000010000000000000000000001000000000000000001000000000000
111111111111111111111111111111111111111111111111111111111111111111111111111111111111111111111111111111111111111111111111
000000000100000000000000000100000000000000000000010000000000000000010000000000000000000001000000000000000001000000000000
000000000100000000000000000100000000000000000000010000000000000000010000000000000000000001000000000000000001000000000000
000000000100000000000000000100000000000000000000010000000000000000010000000000000000000001000000000000000001000000000000
000000000100000000000000000100000000000000000000010000000000000000010000000000000000000001000000000000000001000000000000
000000000100000000000000000100000000000000000000010000000000000000010000000000000000000001000000000000000001000000000000
000000000100000000000000000100000000000000000000010000000000000000010000000000000000000001000000000000000001000000000000
000000000100000000000000000100000000000000000000010000000000000000010000000000000000000001000000000000000001000000000000
000000000100000000000000000100000000000000000000010000000000000000010000000000000000000001000000000000000001000000000000
000000000100000000000000000100000000000000000000010000000000000000010000000000000000000001000000000000000001000000000000
111111111111111111111111111111111111111111111111111111111111111111111111111111111111111111111111111111111111111111111111
000000000100000000000000000000000000000000000000010000000000000000000000000000000000000001000000000000000000000000000000
000000000100000000000000000000000000000000000000010000000000000000000000000000000000000001000000000000000000000000000000
000000000100000000000000000000000000000000000000010000000000000000000000000000000000000001000000000000000000000000000000
000000000100000000000000000000000000000000000000010000000000000000000000000000000000000001000000000000000000000000000000
111111111111111111111111111111111111111111111111111111111111111111111111111111111111111111111111111111111111111111111111
000000000100000000000000000100000000000000000000010000000000000000010000000000000000000001000000000000000001000000000000
000000000100000000000000000100000000000000000000010000000000000000010000000000000000000001000000000000000001000000000000
000000000100000000000000000100000000000000000000010000000000000000010000000000000000000001000000000000000001000000000000
000000000100000000000000000100000000000000000000010000000000000000010000000000000000000001000000000000000001000000000000
000000000100000000000000000100000000000000000000010000000000000000010000000000000000000001000000000000000001000000000000
000000000100000000000000000100000000000000000000010000000000000000010000000000000000000001000000000000000001000000000000
000000000100000000000000000100000000000000000000010000000000000000010000000000000000000001000000000000000001000000000000
000000000100000000000000000100000000000000000000010000000000000000010000000000000000000001000000000000000001000000000000
111111111111111111111111111111111111111111111111111111111111111111111111111111111111111111111111111111111111111111111111
000000000100000000000000000100000000000000000000010000000000000000010000000000000000000001000000000000000001000000000000
000000000100000000000000000100000000000000000000010000000000000000010000000000000000000001000000000000000001000000000000
000000000100000000000000000100000000000000000000010000000000000000010000000000000000000001000000000000000001000000000000
000000000100000000000000000100000000000000000000010000000000000000010000000000000000000001000000000000000001000000000000
000000000100000000000000000100000000000000000000010000000000000000010000000000000000000001000000000000000001000000000000
000000000100000000000000000100000000000000000000010000000000000000010000000000000000000001000000000000000001000000000000
000000000100000000000000000100000000000000000000010000000000000000010000000000000000000001000000000000000001000000000000
000000000100000000000000000100000000000000000000010000000000000000010000000000000000000001000000000000000001000000000000
000000000100000000000000000100000000000000000000010000000000000000010000000000000000000001000000000000000001000000000000
111111111111111111111111111111111111111111111111111111111111111111111111111111111111111111111111111111111111111111111111